12 12 12 12 12 12 12 12 12 12 12 12 12 12 12 12 12 12 12 12 12 12 12 12 12 12 12 12 12 12 12 12 12 12 12 12 12 12 12 12 12 12 12 12 12 12 12 12 12 12 12 12 12 12 12 12 12 12 12 12 12 12 12 12 12 12 12 12 12 12 12 12 12 12 12 12 12 12 12 12 12 12 12 12 12 12 12 12 12 12 12 12 12 12 12 12 12 12 12 12 
12 12 12 12 12 12 12 12 12 12 12 12 12 12 12 12 12 12 12 12 12 12 12 12 12 12 12 12 12 12 12 12 12 12 12 12 12 12 12 12 12 12 12 12 12 12 12 12 12 12 12 12 12 12 12 12 12 12 12 12 12 12 12 12 12 12 12 12 12 12 12 12 12 12 12 12 12 12 12 12 12 12 12 12 12 12 12 12 12 12 12 12 12 12 12 12 12 12 12 12 
12 12 12 12 12 12 12 12 12 12 12 12 12 12 12 12 12 12 12 12 12 12 12 12 12 12 12 12 12 12 12 12 12 12 12 12 12 12 12 12 12 12 12 12 12 12 12 12 12 12 12 12 12 12 12 12 12 12 12 12 12 12 12 12 12 12 12 12 12 12 12 12 12 12 12 12 12 12 12 12 12 12 12 12 12 12 12 12 12 12 12 12 12 12 12 12 12 12 12 12 
12 12 12 12 12 12 12 12 12 12 12 12 12 12 12 12 12 12 12 12 12 12 12 12 12 12 12 12 12 12 12 12 12 12 12 12 12 12 12 12 12 12 12 12 12 12 12 12 12 12 12 12 12 12 12 12 12 12 12 27 12 12 27 12 12 27 12 12 27 12 12 27 12 12 12 12 12 12 12 12 12 12 12 12 12 12 12 12 12 12 12 12 12 12 12 12 12 12 12 12 
12 12 12 12 12 12 12 12 12 12 12 12 12 12 12 12 12 12 12 12 12 12 12 12 12 12 12 12 12 12 12 12 12 12 12 12 12 12 12 12 12 12 12 12 12 12 12 12 12 12 12 12 12 12 12 27 12 12 12 12 12 12 12 12 12 12 12 12 12 12 12 12 12 27 12 12 12 12 12 12 12 12 12 12 12 12 12 12 12 12 12 12 12 12 12 12 12 12 12 12 
12 12 12 12 12 12 12 12 12 12 12 12 12 12 12 12 12 12 12 12 12 12 12 12 12 12 12 12 12 12 12 12 12 12 12 12 12 12 12 12 12 12 12 12 12 12 12 12 12 12 12 27 12 12 12 12 12 12 12 12 12 12 12 12 12 12 12 12 12 12 12 12 12 12 12 12 27 12 12 12 12 12 12 12 12 12 12 12 12 12 12 12 12 12 12 12 12 12 12 12 
12 12 12 12 12 12 12 12 12 12 12 12 12 12 12 12 12 12 12 12 12 12 12 12 12 12 12 12 12 12 12 12 12 12 12 12 12 12 12 12 12 12 12 12 12 12 12 12 27 12 12 12 12 12 12 12 12 12 12 12 12 12 12 12 12 12 12 12 12 12 12 12 12 12 12 12 12 12 12 27 12 12 12 12 12 12 12 12 12 12 12 12 12 12 12 12 12 12 12 12 
12 12 12 12 12 12 12 12 12 12 12 12 12 12 12 12 12 12 12 12 12 12 12 12 12 12 12 12 12 12 12 12 12 12 12 12 12 12 12 12 12 12 12 12 12 12 12 27 12 12 12 12 12 12 12 12 12 12 12 12 12 12 12 12 12 12 12 12 12 12 12 12 12 12 12 12 12 12 12 12 12 12 12 12 12 12 12 12 12 12 12 12 12 12 12 12 12 12 12 12 
12 12 12 12 12 12 12 12 12 12 12 12 12 12 12 12 12 12 12 12 12 12 12 12 12 12 27 12 12 27 12 27 12 12 27 12 12 27 12 27 12 27 27 27 12 12 12 12 12 12 12 12 12 12 12 12 12 12 12 12 12 12 12 12 12 12 12 12 12 12 12 12 12 12 12 12 12 12 12 12 12 12 27 12 12 12 12 12 12 12 12 12 12 12 12 12 12 12 12 12 
12 12 12 12 12 12 12 12 12 12 12 12 12 12 12 12 12 12 12 12 12 12 12 27 12 12 12 12 12 12 12 12 12 12 12 12 12 12 12 12 12 12 12 12 12 12 12 12 12 12 12 12 12 12 12 12 12 12 12 12 27 27 27 27 27 27 27 12 12 12 12 12 12 12 12 12 12 12 12 12 12 12 12 12 12 12 12 12 12 12 12 12 12 12 12 12 12 12 12 12 
12 12 12 12 12 12 12 12 12 12 12 12 12 12 12 12 12 12 12 12 27 12 12 12 12 12 12 12 12 12 12 12 12 12 12 12 12 12 12 12 12 12 12 12 12 12 12 12 12 12 12 12 12 12 12 12 12 12 12 12 12 27 27 12 12 12 27 27 12 27 12 12 12 12 12 12 12 12 12 12 12 12 12 12 27 12 12 12 12 12 12 12 12 12 12 12 12 12 12 12 
12 12 12 12 12 12 12 12 12 12 12 12 12 12 12 12 12 12 27 12 12 12 12 12 12 12 12 12 12 12 12 12 12 12 12 12 12 12 12 12 12 12 12 12 12 12 12 12 12 12 12 12 12 12 12 12 12 12 12 12 12 12 27 27 12 12 12 12 12 12 27 12 12 12 12 12 12 12 12 12 12 12 12 12 12 12 12 12 12 12 12 12 12 12 12 12 12 12 12 12 
12 12 12 12 12 12 12 12 12 12 12 12 12 12 12 12 12 12 12 12 12 12 12 12 12 12 12 12 12 12 12 12 12 12 12 12 12 12 12 12 12 12 12 12 12 12 12 12 12 12 12 12 12 12 12 12 12 12 12 12 12 12 12 27 27 27 27 27 27 27 12 27 12 12 12 12 12 12 12 12 12 12 12 12 12 12 12 27 12 12 12 12 12 12 12 12 12 12 12 12 
12 12 12 12 12 12 12 12 12 12 12 12 12 12 12 27 12 12 12 12 12 12 12 12 12 12 12 12 12 12 12 12 12 12 12 12 12 12 12 12 12 12 12 12 12 12 12 12 12 12 12 12 12 12 12 12 12 12 12 12 12 12 12 12 12 12 12 12 12 12 27 27 12 27 12 12 12 12 12 12 12 12 12 12 12 12 12 12 12 12 12 12 12 12 12 12 12 12 12 12 
12 12 12 12 12 12 12 12 12 12 12 12 12 12 12 12 12 12 12 12 12 12 12 12 12 12 12 12 12 12 12 12 12 12 12 12 12 12 12 12 12 12 12 12 12 12 12 12 12 12 12 12 12 12 12 12 12 12 12 12 12 12 12 12 12 12 12 12 12 12 12 12 12 27 12 27 12 12 12 12 12 12 12 12 12 12 12 12 12 12 27 12 12 12 12 12 12 12 12 12 
12 12 12 12 12 12 12 12 12 12 12 12 27 12 12 12 12 12 12 12 12 12 12 12 12 12 12 12 12 12 12 12 12 12 12 12 12 12 12 12 27 27 12 12 12 12 12 12 12 12 12 12 12 12 12 12 12 12 12 12 12 12 12 12 12 12 12 12 12 12 12 12 12 12 12 12 12 27 12 27 12 12 12 12 12 12 12 12 12 12 12 12 12 12 12 12 12 12 12 12 
12 12 12 12 12 12 12 12 12 12 12 12 12 12 12 12 12 12 12 12 12 12 12 12 12 12 12 12 12 12 12 12 12 12 12 12 12 12 12 27 27 12 12 12 12 12 12 12 12 12 12 27 27 12 12 12 12 12 12 12 12 12 12 12 12 12 12 12 12 12 12 12 12 12 12 12 12 12 27 27 12 27 12 12 12 12 12 12 12 12 12 12 12 12 12 12 12 12 12 12 
12 12 12 12 12 12 12 12 12 12 27 12 12 12 12 12 12 12 12 12 12 12 12 12 12 12 12 12 12 12 12 12 12 12 12 12 12 12 27 12 12 12 12 12 12 12 12 27 12 27 27 12 12 12 12 12 12 12 12 12 12 12 12 12 12 12 12 12 12 12 12 12 12 12 12 12 12 12 12 12 12 12 27 12 12 12 12 12 12 12 12 12 27 12 12 12 12 12 12 12 
12 12 12 12 12 12 12 12 12 12 12 12 12 12 12 12 12 12 12 12 12 12 12 12 12 12 12 12 12 12 12 12 12 12 12 12 27 12 12 12 12 12 12 12 12 27 12 12 12 12 12 12 12 12 12 12 12 12 12 12 12 12 12 12 12 12 12 12 12 12 12 12 12 12 12 12 12 12 12 12 12 27 12 12 12 27 12 12 12 12 12 12 12 12 12 12 12 12 12 12 
12 12 12 12 12 12 12 12 12 27 12 12 12 12 12 12 12 12 12 12 12 12 12 12 12 12 12 12 12 12 12 12 12 12 27 12 12 12 12 12 12 27 12 12 12 12 12 12 12 12 12 12 12 12 12 12 12 12 12 12 12 12 12 12 12 12 12 12 12 12 12 12 12 12 12 12 12 12 12 12 12 12 12 27 12 12 12 12 12 12 12 12 12 12 27 12 12 12 12 12 
12 12 12 12 12 12 12 12 12 27 12 12 12 12 12 12 12 12 12 12 12 12 12 27 12 27 12 27 12 27 12 27 12 12 12 27 12 12 12 12 12 12 12 12 12 12 12 12 12 12 12 12 12 12 12 12 12 12 12 12 12 12 12 12 12 12 12 12 12 12 12 12 12 12 12 12 12 12 12 12 12 12 12 12 27 12 12 12 27 12 12 12 12 12 12 12 12 12 12 12 
12 12 12 12 12 12 12 12 12 12 12 12 12 12 12 12 12 12 12 27 27 27 12 12 12 12 12 12 12 12 12 12 12 12 12 12 12 12 12 12 12 12 12 12 12 12 12 12 12 12 12 12 12 12 12 12 12 12 12 12 12 12 12 12 12 12 12 12 12 12 12 12 12 12 12 12 12 12 12 12 12 12 12 12 12 27 12 12 12 12 12 12 12 12 12 12 12 12 12 12 
12 12 12 12 12 12 12 12 12 12 12 12 12 12 12 12 12 12 27 12 12 12 12 12 12 12 12 12 12 27 12 27 12 12 12 12 12 12 12 12 12 12 12 12 12 12 12 12 12 12 12 12 12 12 12 12 12 12 12 12 12 12 12 12 12 12 12 12 12 12 12 12 12 12 12 12 12 12 12 12 12 12 12 12 12 12 27 12 12 12 12 27 12 12 12 12 27 12 12 12 
12 12 12 12 12 12 12 12 12 12 12 12 12 12 12 12 12 12 12 12 12 12 12 12 12 27 12 27 12 12 12 12 12 12 12 12 12 12 12 12 12 12 12 12 12 12 12 12 12 12 12 12 12 12 12 12 12 12 12 12 12 12 12 12 12 12 12 12 12 12 12 12 12 12 12 12 12 12 12 12 12 12 12 12 12 12 12 27 12 12 12 12 12 12 12 12 12 12 12 12 
12 12 12 12 12 12 12 12 12 12 12 12 12 12 12 12 12 27 12 12 12 12 12 12 27 12 12 12 12 12 12 12 12 12 12 12 12 12 12 12 12 12 12 12 12 12 18 45 45 45 45 45 45 45 45 45 45 45 45 45 45 45 45 45 45 50 12 12 12 12 12 12 12 12 12 12 12 12 12 12 12 12 12 12 12 12 12 12 27 12 12 12 12 12 12 27 12 27 12 12 
12 12 12 12 12 12 12 12 12 12 12 12 12 12 12 12 12 12 12 12 12 12 12 27 12 12 12 12 12 12 12 12 12 12 12 12 12 12 12 18 45 45 45 45 45 45 32 32 32 32 32 43 43 43 32 32 32 32 32 32 32 32 32 32 32 32 45 50 12 12 12 12 12 12 12 12 12 12 12 12 12 12 12 12 12 12 12 12 27 12 12 12 12 12 12 12 12 27 27 12 
12 12 12 12 12 12 12 12 12 12 12 12 12 12 12 12 27 12 12 12 12 27 12 12 12 12 12 12 12 12 12 12 12 12 12 12 12 18 45 32 32 32 32 32 32 32 32 32 32 32 43 32 32 32 43 32 32 32 32 32 32 32 32 32 32 32 32 32 45 45 50 12 12 12 12 12 12 12 12 12 12 12 12 12 12 12 12 12 12 27 12 12 12 12 12 12 12 12 12 27 
12 12 12 12 12 12 12 12 12 12 12 12 12 12 12 12 12 12 27 27 27 12 12 12 12 12 12 12 12 12 12 12 12 12 12 18 45 32 32 32 32 32 32 32 32 32 32 32 32 32 32 43 43 43 43 32 32 32 32 32 32 32 32 32 32 32 32 32 32 32 32 45 50 12 12 12 12 12 12 12 12 12 12 12 12 12 12 12 12 27 12 12 12 12 12 12 12 12 12 12 
12 12 12 12 12 12 12 12 12 12 12 12 12 12 12 12 12 12 12 12 12 12 12 12 12 12 12 12 12 12 12 12 12 12 18 32 32 32 32 32 32 32 32 32 32 32 32 32 32 32 32 32 32 8 32 32 32 32 32 32 32 32 32 32 32 32 32 32 32 32 32 32 32 50 12 12 12 12 12 12 12 12 12 12 12 12 12 12 12 12 27 12 12 12 12 12 12 12 12 12 
12 12 12 12 12 12 12 12 12 12 12 12 12 12 12 27 12 12 12 12 12 12 12 12 12 12 12 12 12 12 12 12 12 12 35 32 32 32 32 32 32 32 32 32 32 32 32 32 32 32 32 32 32 54 10 32 32 32 32 32 32 32 32 32 32 32 32 32 32 32 32 32 32 32 45 50 12 12 12 12 12 12 12 12 12 12 12 12 12 12 27 12 12 12 12 12 12 12 12 12 
12 12 12 12 12 12 12 12 12 12 12 12 12 12 12 12 12 12 12 12 12 12 12 12 12 12 12 12 12 12 12 12 33 18 32 32 32 32 32 32 32 32 32 32 32 32 32 32 32 32 32 32 32 32 54 10 32 32 32 32 32 32 32 32 32 32 32 32 32 32 32 32 32 32 32 32 50 12 12 12 12 12 12 12 12 12 12 12 12 12 12 12 12 12 12 12 12 12 12 12 
12 12 12 12 12 12 12 12 12 12 12 12 12 12 27 12 12 12 12 12 12 12 12 12 12 12 12 12 12 12 12 33 18 32 32 32 32 32 32 32 32 32 32 32 32 32 32 32 32 32 32 32 32 32 32 54 10 32 32 32 6 2 2 2 2 2 10 32 32 32 32 43 32 43 32 32 32 50 12 12 12 12 12 12 12 12 12 12 12 12 12 27 12 12 12 12 12 12 12 12 
12 12 12 12 12 12 12 12 12 12 12 12 12 12 27 12 12 12 12 12 12 12 12 12 12 12 12 12 12 12 12 33 35 32 32 32 32 32 32 32 43 32 32 32 32 32 32 32 32 32 32 32 32 32 32 32 54 10 32 6 9 32 32 32 32 32 54 2 2 10 32 32 32 32 32 32 32 37 12 12 12 12 12 12 12 12 12 12 12 12 12 12 27 12 12 12 12 12 12 12 
12 12 12 12 12 12 12 12 12 12 12 12 12 12 27 12 12 12 12 12 12 12 12 12 12 12 12 12 12 12 12 33 35 32 32 32 32 32 32 43 32 43 32 32 32 32 32 32 32 32 32 32 32 32 32 32 32 54 5 9 32 32 32 32 32 32 32 32 32 54 2 43 32 32 43 32 32 37 12 12 12 12 12 12 12 12 12 12 12 12 12 12 12 27 12 12 12 12 12 12 
12 12 12 12 12 12 12 12 12 12 12 12 12 12 12 12 12 12 29 29 29 29 29 29 12 12 12 12 12 12 12 33 35 32 32 32 32 32 32 32 43 32 32 32 2 2 2 2 2 2 2 2 2 2 2 2 2 2 7 32 32 32 32 32 32 32 32 32 32 32 32 32 32 32 32 32 32 37 12 12 12 12 12 12 12 12 12 12 12 12 12 12 12 27 27 12 12 12 12 12 
12 12 12 12 12 12 12 12 12 12 12 12 12 12 12 12 29 29 12 12 12 12 12 29 12 12 12 12 12 12 12 33 48 32 32 32 32 32 32 32 43 32 32 32 32 32 32 32 32 32 32 32 32 32 32 32 32 32 54 10 32 32 32 32 32 32 32 32 32 32 32 32 43 32 43 32 32 37 12 12 12 12 12 12 12 12 12 12 12 12 12 12 12 12 27 12 12 12 12 12 
12 12 12 12 12 12 12 12 12 12 12 12 12 12 29 29 12 12 12 12 12 12 12 29 12 12 12 12 12 12 12 12 33 48 32 32 32 32 32 32 32 32 32 32 32 32 32 32 32 32 32 32 32 32 32 32 32 32 32 8 32 32 32 32 32 32 32 32 32 32 32 32 32 32 32 32 32 41 12 12 12 12 12 12 12 12 12 12 12 12 12 12 12 12 12 12 12 12 12 12 
12 12 12 12 12 12 12 12 12 12 12 12 12 29 12 12 12 12 29 29 29 12 12 29 12 12 12 12 12 12 12 12 15 33 48 44 32 32 32 32 32 32 32 32 32 32 32 32 32 32 32 32 32 32 32 32 32 32 32 8 32 32 32 32 32 32 32 32 32 32 32 32 32 32 32 32 41 33 12 12 12 12 12 12 12 12 12 12 12 12 12 12 12 12 12 12 12 12 12 12 
12 12 12 12 12 12 12 12 12 12 12 12 29 12 12 12 12 29 29 12 29 12 12 12 12 12 12 12 12 12 12 12 12 15 33 33 48 44 32 32 32 32 32 32 32 32 32 32 32 32 32 32 32 32 32 32 44 44 44 55 44 44 44 44 44 44 32 32 32 32 32 32 32 32 32 41 33 29 12 12 12 12 12 12 27 27 12 12 12 12 12 12 12 12 12 12 12 12 12 12 
12 12 12 12 12 12 12 12 12 12 12 29 12 12 12 12 12 29 12 12 12 12 12 29 12 12 12 12 12 12 12 12 12 12 12 15 33 33 48 44 44 32 32 32 32 32 32 32 32 32 44 44 44 44 44 41 33 33 33 66 33 33 33 33 33 33 48 44 44 44 44 44 44 44 41 33 29 12 12 12 12 12 12 12 12 27 12 12 12 12 12 12 12 12 12 12 12 12 12 12 
12 12 12 12 12 12 12 12 12 12 29 12 12 12 12 12 12 29 29 29 29 29 29 29 12 29 12 12 12 12 12 12 12 12 12 12 12 15 33 33 33 48 44 44 32 32 32 44 44 41 33 33 33 33 33 33 29 12 12 66 12 12 12 12 12 15 33 33 33 33 33 33 33 33 33 29 12 12 12 12 12 12 12 12 12 27 12 12 12 12 12 12 12 12 12 12 12 12 12 12 
12 12 12 12 12 12 12 12 12 12 29 12 12 12 12 12 29 29 12 12 12 12 12 29 12 12 12 27 27 12 29 12 12 12 12 12 12 12 12 12 15 33 33 33 48 44 41 33 33 33 29 12 12 12 12 12 27 12 12 66 12 12 12 12 12 12 12 12 12 12 12 12 12 12 12 12 12 12 12 12 12 12 12 12 12 12 27 12 12 12 12 12 12 12 12 12 12 12 12 12 
12 12 12 12 12 12 12 12 12 12 12 12 12 29 12 29 29 12 12 12 12 12 12 12 12 27 27 12 12 12 12 29 29 29 12 12 12 12 12 12 12 12 12 15 33 33 33 29 12 12 12 12 12 12 12 27 12 12 12 66 12 12 12 12 12 12 12 12 12 12 12 12 12 12 12 12 12 12 12 12 12 12 12 12 12 12 27 12 12 12 12 12 12 12 12 12 12 12 12 12 
12 12 12 12 12 12 12 12 12 12 29 12 12 12 29 12 12 12 12 12 12 29 12 27 27 12 12 12 12 12 12 12 12 29 29 12 12 12 12 12 12 12 12 12 12 12 12 12 12 12 12 12 12 12 27 27 12 12 12 66 12 12 12 12 12 12 12 12 29 29 12 12 12 12 12 12 12 12 12 12 12 12 12 12 12 12 12 27 12 12 12 12 12 12 12 12 12 12 12 12 
12 12 12 12 12 12 12 12 12 12 12 29 12 29 27 27 27 12 27 27 12 27 12 12 12 12 12 12 12 12 12 12 12 12 29 12 12 12 12 12 12 12 12 12 12 12 12 12 12 12 12 12 12 12 27 12 12 12 12 66 12 12 12 12 12 12 29 29 12 12 12 12 12 12 12 12 12 12 12 12 12 12 12 12 12 12 12 12 12 12 12 12 12 12 12 12 12 12 12 12 
12 12 12 12 12 12 12 12 12 29 12 29 12 27 12 12 12 12 12 12 29 12 29 12 12 12 12 12 12 12 12 12 12 12 29 12 12 12 12 12 12 12 12 12 12 12 12 12 29 29 29 29 27 27 12 12 12 12 12 66 12 12 12 12 12 12 29 29 12 12 12 12 12 12 12 12 12 12 12 12 12 12 12 12 29 12 29 12 27 29 12 29 29 12 12 12 12 12 12 12 
12 12 12 12 12 12 12 12 29 29 29 12 12 12 12 12 12 12 12 12 12 12 12 12 12 12 12 12 12 12 12 12 12 12 12 27 27 27 12 27 27 12 27 12 27 27 27 29 27 27 12 27 12 12 12 12 12 12 12 66 12 12 12 12 12 12 12 29 29 12 12 12 12 12 12 12 12 12 12 12 29 12 29 12 12 12 12 12 27 12 12 12 29 12 12 12 12 12 12 12 
12 12 12 12 12 12 29 29 29 12 12 27 12 12 12 12 12 12 12 12 12 12 12 12 12 12 12 12 12 12 12 12 12 12 12 27 29 29 12 12 12 12 12 12 12 29 29 12 12 12 12 12 12 12 12 12 12 12 12 66 12 12 12 12 12 12 12 12 12 29 29 29 29 12 29 12 12 12 29 29 12 12 12 12 12 12 12 12 12 12 12 12 29 12 12 12 12 12 12 12 
12 12 12 12 12 12 29 12 12 29 12 12 12 12 12 12 12 12 12 12 29 12 12 12 12 12 12 12 12 12 12 12 12 12 12 12 12 12 29 29 12 29 12 29 29 29 12 12 12 12 12 12 12 12 18 45 45 45 45 31 32 45 50 12 12 12 12 12 12 12 12 12 12 12 12 12 29 12 12 29 12 29 12 12 12 12 12 12 12 12 27 29 12 12 12 12 12 12 12 12 
12 12 12 12 12 12 12 12 12 29 27 12 12 12 12 12 12 12 12 29 12 12 12 12 12 12 12 12 12 12 12 12 12 12 12 12 12 12 12 12 12 12 12 12 12 12 12 12 12 12 12 18 45 45 32 32 32 32 6 8 10 32 32 50 12 12 12 12 12 12 12 12 12 12 12 12 12 12 12 12 12 12 29 29 12 29 12 12 12 12 29 12 12 12 12 12 12 12 12 12 
12 12 12 12 12 12 12 12 12 29 12 12 12 12 12 12 12 12 12 12 12 12 12 12 12 12 12 18 45 45 45 45 50 12 12 12 12 12 12 12 12 18 45 45 45 45 45 45 45 45 45 32 32 32 32 32 32 32 6 8 9 32 32 32 45 50 12 12 12 12 12 12 12 12 12 12 12 12 12 12 12 12 12 12 12 12 29 29 12 29 12 12 12 12 12 12 12 12 12 12 
12 12 12 12 12 12 12 12 12 29 12 12 12 12 12 12 12 12 29 29 12 12 12 12 12 12 18 32 32 32 32 32 32 45 45 45 45 45 45 45 45 32 32 32 32 32 32 32 32 32 32 32 32 32 32 32 32 32 54 8 10 32 32 32 32 32 45 45 45 50 12 12 12 12 12 12 12 12 12 12 12 12 12 12 12 12 12 29 29 29 12 27 12 12 12 12 12 12 12 12 
12 12 12 12 12 12 12 12 12 27 29 12 12 12 12 12 12 12 12 12 12 12 12 12 12 12 35 32 32 32 32 32 32 32 32 32 32 32 32 32 32 32 32 32 32 32 32 32 32 32 32 32 32 32 32 32 32 32 6 8 9 32 32 32 32 32 32 32 32 32 45 50 12 12 12 12 12 12 12 12 12 12 12 12 12 12 12 29 12 12 12 12 12 12 12 12 12 12 12 12 
12 12 12 12 12 12 12 12 12 12 12 12 12 12 12 12 12 29 12 12 12 12 12 12 18 45 32 32 32 32 32 32 32 32 32 32 32 32 32 32 32 32 32 32 32 32 32 32 32 32 32 32 32 32 32 32 32 32 54 8 10 32 32 32 32 32 32 32 32 32 32 32 45 45 50 12 12 12 12 12 12 12 12 12 12 12 29 12 12 12 12 12 12 12 12 12 12 12 12 12 
12 12 12 12 12 12 12 12 12 12 12 29 12 12 12 12 12 29 12 12 12 12 12 18 32 32 32 32 32 32 32 43 43 43 32 32 32 32 32 32 32 32 32 32 32 32 32 32 32 32 32 32 32 32 32 32 32 32 6 8 9 32 32 32 32 32 32 32 32 32 32 32 32 32 32 45 50 12 12 12 12 12 12 12 12 12 29 12 12 12 12 12 12 27 12 12 12 12 12 12 
12 12 12 12 12 12 12 12 12 27 12 12 12 12 12 12 29 12 12 12 12 12 18 32 32 32 32 32 32 32 43 43 43 43 43 32 32 32 32 32 32 32 32 32 32 32 32 32 32 32 32 32 32 32 32 32 32 32 54 8 10 32 32 32 32 32 32 32 32 32 32 32 32 32 32 32 32 50 12 12 12 12 12 12 12 12 29 12 12 12 12 12 12 12 12 12 12 12 12 12 
12 12 12 12 12 12 12 12 12 12 12 29 12 12 12 29 29 12 12 12 12 12 35 32 32 32 32 32 32 32 43 43 43 43 43 2 2 2 2 2 2 2 10 32 32 32 32 32 32 32 32 32 32 32 32 32 32 32 6 2 9 32 32 32 32 32 32 32 32 32 32 32 32 32 32 32 32 32 12 12 12 12 12 12 12 12 12 29 12 12 12 12 12 12 27 12 12 12 12 12 
12 12 12 12 12 12 12 12 12 27 12 12 12 29 29 12 12 12 12 12 12 12 35 32 32 32 32 32 32 32 43 43 43 43 43 32 32 32 32 32 32 32 54 10 32 32 32 32 32 32 32 32 32 32 32 32 32 6 2 9 32 32 32 32 32 32 32 32 32 32 32 32 32 32 32 32 32 32 50 12 12 12 12 12 12 12 12 12 12 12 12 12 12 12 12 27 12 12 12 12 
12 12 12 12 12 12 12 12 12 27 12 12 29 29 29 12 12 12 12 12 12 18 32 32 32 32 32 32 32 32 32 43 43 43 32 32 32 32 32 32 32 32 32 8 32 32 32 32 32 32 32 32 32 32 32 32 6 2 9 32 32 32 32 32 32 32 32 32 32 32 43 32 32 32 43 32 32 32 37 12 12 12 12 12 12 12 12 29 12 12 12 12 12 12 12 12 12 12 12 12 
12 12 12 12 12 12 12 12 12 12 12 12 29 29 29 12 12 12 12 12 12 48 32 32 32 32 32 32 32 32 32 32 32 32 32 32 32 32 32 32 32 32 32 54 10 32 32 32 32 32 32 32 32 32 32 32 8 8 32 32 32 32 32 32 32 32 32 32 32 32 32 43 32 43 32 32 32 32 37 12 12 12 12 12 12 12 12 12 12 12 12 12 12 12 12 12 12 12 12 12 
12 12 12 12 12 12 12 12 12 12 12 12 12 29 29 12 12 12 12 12 12 33 35 32 32 32 32 32 32 32 32 32 32 32 32 32 32 32 32 32 32 32 32 32 8 32 32 32 32 32 32 32 32 32 32 6 1 1 2 2 2 2 2 2 2 2 2 2 2 2 2 2 43 32 32 32 32 32 37 12 12 12 12 12 12 12 12 12 29 12 12 12 12 12 12 12 12 12 12 12 
12 12 12 12 12 12 12 12 12 12 12 29 12 29 29 29 12 12 12 12 12 33 48 32 32 32 32 32 32 44 44 44 44 44 32 32 32 32 32 32 32 32 32 32 8 32 32 32 32 32 32 32 32 32 6 9 32 32 32 32 32 32 32 32 32 32 32 32 32 32 32 43 32 43 32 32 32 32 37 12 12 12 12 12 12 12 12 12 12 29 12 12 12 12 12 12 12 12 12 12 
12 12 12 12 12 12 12 12 12 29 12 12 12 29 12 29 12 12 12 12 12 15 33 48 32 32 32 32 37 20 20 20 27 33 35 32 32 32 32 32 32 32 32 32 0 2 2 2 5 2 2 2 2 2 9 32 32 32 32 32 32 32 32 32 32 32 32 32 32 32 43 32 32 32 43 32 32 32 41 12 12 12 12 12 12 12 12 12 12 12 12 12 12 12 12 12 12 12 12 12 
12 12 12 12 12 12 12 29 29 12 12 12 12 29 12 29 12 12 12 12 12 12 15 33 35 32 32 32 37 12 12 15 28 33 35 32 32 32 32 32 32 32 32 32 8 32 32 32 8 32 32 32 32 32 32 32 32 32 32 32 32 32 32 32 32 32 32 32 32 32 32 32 32 32 43 32 32 37 33 12 12 12 12 12 12 12 12 12 12 12 29 12 12 12 12 12 12 12 12 12 
12 12 12 12 12 12 29 12 12 12 12 12 12 12 29 12 12 12 12 12 12 12 12 33 48 32 32 32 37 12 12 15 15 33 35 32 32 32 32 32 32 32 32 32 8 32 32 32 54 2 10 32 32 32 32 32 32 32 32 32 32 32 32 32 32 32 32 32 32 32 32 32 32 32 32 32 32 37 29 12 12 12 12 12 12 29 12 12 12 12 12 29 12 12 12 12 12 12 12 12 
12 12 12 12 12 12 29 12 12 12 12 12 29 29 12 12 12 12 12 12 12 12 12 15 33 48 32 32 37 12 12 15 15 33 35 32 32 32 32 32 32 32 6 2 9 32 32 32 32 32 8 32 32 32 32 32 32 32 32 43 32 32 32 32 32 32 32 32 32 32 32 32 32 32 32 32 32 41 12 12 12 12 12 12 12 29 29 12 12 12 12 29 29 29 12 12 12 12 12 12 
12 12 12 12 12 12 29 29 12 29 29 29 12 12 12 29 29 29 29 29 29 12 12 12 15 33 48 32 37 12 12 12 28 33 35 32 32 6 2 2 2 2 9 32 32 32 32 32 32 32 54 10 32 32 32 32 32 32 43 43 43 32 32 32 32 32 32 32 32 32 32 32 32 32 32 44 41 33 12 12 12 12 12 12 29 12 29 12 12 12 12 12 12 12 12 12 12 12 12 12 
12 12 12 12 12 12 12 12 12 12 12 12 12 12 29 29 12 12 12 12 12 12 12 12 12 15 33 35 32 45 45 45 45 45 32 32 32 8 32 32 32 32 32 32 32 32 32 32 32 32 32 8 32 32 32 32 32 43 43 43 43 43 32 32 32 32 32 32 32 32 32 32 32 32 41 33 33 29 12 12 12 12 12 29 12 12 12 29 12 12 12 12 12 12 12 12 12 12 12 12 
12 12 12 12 12 12 12 12 12 12 12 12 12 29 12 27 27 12 12 12 12 12 12 12 12 12 12 35 32 32 32 32 32 32 32 32 32 8 32 32 32 32 32 32 32 32 32 32 32 32 32 54 2 2 2 2 43 43 43 43 43 43 43 32 32 32 32 32 32 32 32 32 32 41 33 29 12 12 12 12 12 12 29 29 12 12 12 12 12 12 12 12 12 12 12 12 12 12 12 12 
12 12 12 12 12 12 12 12 29 29 29 29 29 12 27 29 29 12 12 12 12 12 12 12 12 12 18 32 32 32 32 32 32 32 32 43 43 43 43 32 32 32 32 32 32 32 32 32 32 32 32 32 32 32 32 43 43 43 43 43 43 43 43 43 32 32 32 32 32 32 32 32 37 33 29 12 12 12 12 12 29 12 12 12 12 12 12 12 12 12 12 12 12 12 12 12 12 12 12 12 
12 12 12 12 12 12 12 12 29 29 29 12 27 27 12 12 12 12 12 12 12 12 12 12 12 18 32 32 32 32 32 32 32 43 43 43 43 43 43 43 43 32 32 32 32 32 32 32 32 32 32 32 32 32 43 43 43 43 43 43 43 43 43 43 43 32 32 32 32 32 32 32 37 12 12 12 12 12 29 12 12 12 29 12 12 12 12 12 29 12 12 12 12 12 12 12 12 12 12 12 
12 12 12 12 12 12 12 12 29 12 27 12 12 12 12 12 12 12 12 12 12 12 12 12 18 32 32 32 32 32 32 32 32 32 43 43 43 43 43 43 32 32 32 32 32 32 32 32 32 32 32 32 32 32 43 43 43 43 43 43 43 43 43 43 43 32 32 32 32 32 32 32 37 12 12 12 12 29 12 12 12 12 12 12 12 12 12 12 12 12 12 12 12 12 12 12 12 12 12 12 
12 12 12 12 12 12 12 29 12 27 12 12 12 12 12 12 12 12 12 12 12 12 12 18 32 32 32 32 32 32 32 32 32 32 43 43 43 43 43 43 32 32 32 32 32 32 32 32 32 32 32 32 32 32 32 32 32 32 32 32 32 32 32 32 32 32 32 32 32 32 32 32 37 12 12 12 29 12 12 12 12 29 12 12 12 12 12 12 29 12 12 12 12 12 12 12 12 12 12 12 
12 12 12 12 12 12 29 12 27 12 12 12 12 12 12 12 12 12 12 12 12 12 18 32 32 32 32 32 32 32 32 32 32 43 43 43 43 43 43 43 43 32 32 32 32 32 32 32 32 32 32 32 32 32 32 32 32 32 32 32 32 32 32 32 32 32 32 32 32 32 32 32 37 12 12 12 29 29 29 12 12 12 12 12 12 12 12 12 12 12 12 12 12 12 12 12 12 12 12 12 
12 12 12 12 12 29 12 27 29 12 12 12 12 12 12 12 12 12 12 12 12 18 32 32 32 32 32 32 32 32 32 32 32 32 32 43 43 43 43 32 32 32 32 32 32 32 32 32 32 32 32 32 32 32 32 32 32 32 32 32 32 32 32 32 32 32 32 32 32 32 32 32 37 12 12 12 12 12 12 29 29 12 12 12 12 12 12 12 12 29 12 12 12 12 12 12 12 12 12 12 
12 12 12 12 12 12 12 12 12 12 12 12 12 12 12 12 12 12 12 12 12 35 32 32 32 32 32 32 32 32 32 32 32 32 32 32 32 32 32 32 32 32 32 32 32 32 32 32 32 32 32 32 32 32 32 32 32 32 32 32 32 32 32 32 32 32 32 32 32 32 32 44 41 12 12 12 12 12 12 12 29 29 12 12 12 12 12 12 12 29 12 12 12 12 12 12 12 12 12 12 
12 12 12 12 29 12 12 27 12 29 12 12 12 12 12 12 12 12 12 12 12 35 32 32 32 32 32 32 32 32 32 32 32 32 32 32 32 32 32 32 32 32 32 32 32 32 32 32 32 32 32 32 32 32 32 32 32 32 32 32 32 44 44 44 44 44 44 44 44 44 41 33 33 12 12 12 12 12 12 29 12 29 12 12 12 12 12 12 12 29 12 12 12 12 12 12 12 12 12 12 
12 12 12 12 29 12 12 12 12 12 29 12 12 12 12 12 12 12 12 12 12 48 44 44 44 44 44 32 32 32 32 32 32 32 32 32 32 32 32 32 32 32 32 32 32 32 32 44 44 44 44 44 44 32 32 32 32 32 32 32 41 33 33 33 33 33 33 33 33 33 33 29 12 12 12 12 12 12 12 29 12 29 12 12 12 12 12 12 12 29 12 12 12 12 12 12 12 12 12 12 
12 12 12 29 12 12 27 12 12 12 12 12 12 12 12 12 12 12 12 12 12 33 33 33 33 33 33 48 44 44 44 44 32 32 32 32 32 32 32 32 32 32 32 32 32 44 41 33 33 33 33 33 33 48 44 44 44 44 44 41 33 29 12 12 12 12 12 12 12 12 12 12 12 12 12 12 12 12 29 29 12 12 12 12 12 12 12 12 12 29 12 12 12 12 12 12 12 12 12 12 
12 12 12 12 12 12 12 12 12 12 12 12 29 12 12 12 12 12 12 12 12 12 12 12 12 12 15 33 33 33 33 33 48 44 44 44 44 44 44 32 32 32 32 44 41 33 33 29 12 12 12 12 15 33 33 33 33 33 33 33 29 12 12 12 12 12 12 12 12 12 12 12 12 12 12 12 29 29 29 29 12 29 12 12 12 12 12 12 12 29 12 12 12 12 12 12 12 12 12 12 
12 12 12 12 12 12 12 12 12 12 12 12 12 12 12 12 12 12 12 12 12 12 12 12 12 12 12 12 12 12 12 15 33 33 33 33 33 33 33 48 44 44 41 33 33 29 12 12 12 12 12 12 12 12 12 12 12 12 12 12 12 12 12 12 12 12 12 12 12 12 12 12 12 12 12 12 12 12 29 12 12 29 12 12 12 12 12 12 12 12 12 12 12 12 12 12 12 12 12 12 
12 12 12 12 12 12 27 12 12 29 29 29 29 29 12 29 12 12 12 12 12 12 12 12 12 12 12 12 12 12 12 12 12 12 12 12 12 12 15 33 33 33 33 29 12 12 12 12 12 12 12 12 12 12 12 12 12 12 12 12 12 12 12 12 12 12 12 12 12 12 12 12 12 12 29 12 12 29 12 12 29 29 12 12 12 12 12 12 29 12 12 12 12 12 12 12 12 12 12 12 
12 12 12 12 12 12 12 29 29 12 12 12 12 29 12 29 12 29 12 12 12 12 12 12 12 12 12 12 12 12 12 12 12 12 12 12 12 12 12 12 12 12 12 12 12 12 12 12 12 12 12 12 12 12 12 12 12 12 12 12 12 12 12 12 12 12 12 12 12 12 12 12 29 12 12 12 12 29 12 12 29 12 12 12 12 12 12 29 12 12 12 12 12 12 12 12 12 12 12 12 
12 12 12 12 12 12 12 29 12 12 12 12 12 12 12 12 29 12 12 29 29 29 12 12 12 12 12 29 12 12 12 12 12 12 12 12 12 12 12 12 12 12 12 12 12 12 12 12 12 12 12 12 12 12 12 29 12 12 12 29 12 12 12 12 29 12 12 12 29 12 29 12 29 12 12 12 29 12 12 12 12 12 12 12 12 12 12 29 12 12 12 12 12 12 12 12 12 12 12 12 
12 12 12 12 12 12 12 29 12 12 12 12 12 12 12 12 29 12 12 12 12 29 29 12 12 29 29 12 12 12 12 12 12 12 12 12 12 12 12 12 12 12 12 12 12 12 12 12 12 12 12 29 12 12 12 12 12 12 12 12 12 12 12 12 12 12 12 12 12 12 12 12 12 12 12 29 12 12 29 12 29 29 12 29 29 29 29 12 12 12 12 12 12 12 12 12 12 12 12 12 
12 12 12 12 12 12 27 29 12 12 12 12 12 12 12 12 12 29 12 12 12 12 29 12 29 29 29 29 12 29 12 29 12 12 12 12 12 12 12 12 12 12 12 12 12 12 12 29 12 12 12 12 12 12 12 12 12 12 12 12 12 12 12 12 12 12 12 12 12 29 12 12 12 12 12 29 12 12 12 12 12 12 29 12 12 12 12 12 12 12 12 12 12 12 12 12 12 12 12 12 
12 12 12 12 12 12 12 29 12 12 12 29 29 29 12 29 29 12 29 29 29 29 29 12 29 12 12 12 12 12 12 12 12 29 29 12 12 12 12 12 12 12 12 12 12 12 12 12 12 12 12 29 12 29 12 12 12 12 12 12 12 12 12 12 12 12 12 12 12 12 12 12 12 12 29 12 12 12 12 12 12 12 29 12 12 12 12 12 12 12 12 12 12 12 12 12 12 12 12 12 
12 12 12 12 12 12 12 29 12 29 12 12 12 12 12 12 12 12 12 12 12 12 29 29 12 12 12 12 12 12 12 12 12 12 12 12 29 29 29 12 12 12 12 12 29 12 12 12 29 12 12 12 12 12 29 29 29 29 29 29 29 29 29 12 12 12 12 29 12 12 12 12 12 29 12 12 12 12 12 29 12 29 12 12 12 12 12 12 12 12 12 12 12 12 12 12 12 12 12 12 
12 12 12 12 12 12 27 29 12 12 12 12 12 12 12 12 12 12 12 29 12 29 12 29 12 12 12 12 12 12 12 12 12 12 12 12 12 12 12 12 12 12 12 29 12 12 12 12 12 12 12 12 12 12 29 12 12 12 12 12 12 12 12 29 29 29 29 29 12 12 29 29 29 12 12 12 12 12 12 12 12 12 12 12 12 12 12 12 12 12 12 12 12 12 12 12 12 12 12 12 
12 12 12 12 12 12 29 29 29 12 12 29 12 12 29 12 12 29 12 12 29 12 29 29 12 12 29 12 12 12 12 29 12 12 12 29 27 27 27 27 27 27 27 27 27 27 27 27 12 12 12 12 12 12 29 12 12 12 12 12 12 12 12 12 12 12 29 29 29 29 29 12 12 12 12 12 29 12 12 12 12 12 12 12 12 12 12 12 12 12 12 12 12 12 12 12 12 12 12 12 
12 12 12 12 12 29 27 12 12 12 12 12 12 12 12 12 12 12 29 12 12 29 29 12 12 12 12 12 12 12 12 12 12 12 27 12 12 12 12 29 29 12 12 12 12 12 12 12 12 12 12 12 12 12 29 12 12 12 12 12 12 12 12 29 12 12 29 12 12 12 12 12 12 29 12 12 12 12 12 12 12 12 12 12 12 12 12 12 12 12 12 12 12 12 12 12 12 12 12 12 
12 12 12 12 12 12 27 12 12 12 12 12 12 12 12 12 29 12 12 12 29 29 29 12 29 29 12 12 12 12 12 27 12 12 12 12 12 12 29 29 12 12 12 12 12 12 12 12 12 12 12 12 12 12 12 12 12 12 12 12 12 12 12 29 29 29 12 29 12 12 29 12 12 12 12 12 12 12 12 12 12 12 12 12 12 12 12 12 12 12 12 12 12 12 12 12 12 12 12 12 
12 12 12 12 12 12 12 29 29 12 12 12 12 29 29 29 12 29 12 12 12 12 12 12 12 12 12 12 12 12 12 12 12 12 29 29 29 29 29 12 12 12 12 12 12 12 12 12 12 12 12 12 12 12 12 12 12 12 12 12 12 12 12 12 12 29 12 12 12 12 12 12 12 12 12 12 12 12 12 12 12 12 12 12 12 12 12 12 12 12 12 12 12 12 12 12 12 12 12 12 
12 12 12 12 12 12 12 12 12 29 12 29 29 12 12 12 12 12 12 12 12 12 12 12 12 12 12 27 12 12 12 12 29 29 12 12 12 12 12 29 29 29 29 12 12 12 12 12 12 12 12 12 12 12 12 12 12 12 12 12 12 12 12 12 12 29 12 12 12 12 12 12 12 12 12 12 12 12 12 12 12 12 12 12 12 12 12 12 12 12 12 12 12 12 12 12 12 12 12 12 
12 12 12 12 12 12 12 12 12 12 12 12 12 12 12 12 12 12 12 12 12 12 12 27 12 12 12 12 12 12 29 29 12 12 12 12 12 12 12 12 12 12 12 29 29 12 12 12 12 12 12 12 12 12 12 12 12 12 12 12 12 12 12 12 29 12 12 12 12 12 12 12 12 12 12 12 12 12 12 12 12 12 12 12 12 12 12 12 12 12 12 12 12 12 12 12 12 12 12 12 
12 12 12 12 12 12 12 12 12 12 12 12 12 12 12 12 12 12 12 12 12 12 12 12 12 12 12 12 12 29 12 12 12 12 12 12 12 12 12 12 12 12 12 12 12 29 12 12 12 12 12 12 12 12 12 12 12 12 12 12 12 12 12 29 12 12 12 12 12 12 12 12 12 12 12 12 12 12 12 12 12 12 12 12 12 12 12 12 12 12 12 12 12 12 12 12 12 12 12 12 
12 12 12 12 12 12 12 12 12 12 12 12 12 12 12 12 12 12 12 12 27 12 29 12 12 29 12 29 12 12 12 12 12 12 12 12 12 12 12 12 12 12 12 12 12 12 12 12 12 12 12 12 12 12 12 12 12 12 12 12 12 12 12 12 12 12 12 12 12 12 12 12 12 12 12 12 12 12 12 12 12 12 12 12 12 12 12 12 12 12 12 12 12 12 12 12 12 12 12 12 
12 12 12 12 12 12 12 12 12 12 12 12 12 12 29 29 29 27 12 29 12 12 12 12 12 12 12 12 12 12 12 12 12 12 12 12 12 12 12 12 12 12 12 12 12 12 12 12 12 12 12 12 12 12 12 12 12 12 12 12 12 12 12 12 12 12 12 12 12 12 12 12 12 12 12 12 12 12 12 12 12 12 12 12 12 12 12 12 12 12 12 12 12 12 12 12 12 12 12 12 
12 12 12 12 12 12 12 12 12 12 12 12 12 12 12 27 27 12 12 12 12 12 12 12 12 12 12 12 12 12 12 12 12 12 12 12 12 12 12 12 12 12 12 12 12 12 12 12 12 12 12 12 12 12 12 12 12 12 12 12 12 12 12 12 12 12 12 12 12 12 12 12 12 12 12 12 12 12 12 12 12 12 12 12 12 12 12 12 12 12 12 12 12 12 12 12 12 12 12 12 
12 12 12 12 12 12 12 12 12 12 12 12 12 12 12 12 12 12 12 12 12 12 12 12 12 12 12 12 12 12 12 12 12 12 12 12 12 12 12 12 12 12 12 12 12 12 12 12 12 12 12 12 12 12 12 12 12 12 12 12 12 12 12 12 12 12 12 12 12 12 12 12 12 12 12 12 12 12 12 12 12 12 12 12 12 12 12 12 12 12 12 12 12 12 12 12 12 12 12 12 
